NO ./textures/imag1_64.xpm
SO ./textures/imag2_64.xpm
WE ./textures/imag3_64.xpm
EA ./textures/imag4_64.xpm

F 220,100,0
C 225,30,0

11111111  1111111
1000000111100000111111
10110000001011101
10000001111000001
10110000000011101
100100N0100000001
10111000100011101
10000001111110001
10000111    10001
11111111    11111