NO ./textures/nourth.xpm
SO ./textures/nourth.xpm
WE ./textures/nourth.xpm
EA ./textures/nourth.xpm

F 210,00,023
C 220,100,255

 
  
1111111111111
1000000000001
1111000000001
1111100000001
1100000000001
10E0010000001
1000000000001
1111111111111