NO ./textures/nourth.xpm
SO    ./textures/nourth.xpm
WE ./textures/nourth.xpm
EA ./textures/nourth.xpm

F 210,00,023
C 220,100,255

 
  
1111111111
1000000001
1111011111
1111011111
1100000011
1000000001
1000000N01
1111111111