NO ./textures/nourth.xpm
SO ./textures/nourth.xpm
WE ./textures/nourth.xpm
EA ./textures/nourth.xpm

F 210,00,023
C 220,100,255

11111111111111111111111111111111111111111111
1000000000110000000000001111111111111111111
10110000011100000000000011111111111111111
100100000000000000000000111111111111111111111111111111
111111111011000001110000000000001
100000000011000001110111111111111
11110111111111011100000010001
11110111111111011101010010001
11000000110101011100000010001
100000000000000011000000W0001
10000000000000001110101001001
110000011101010111110111100111
11110111 1110101 101111010001
11111111 1111111 111111111111