NO ./textures/imag1_64.xpm
SO ./textures/imag2_64.xpm
WE ./textures/imag3_64.xpm
EA ./textures/imag4_64.xpm

F 210,00,023
C 220,100,255


1111111111111
1000000000001
1000000000001
1000000000001
1000000000001
1000000000001
1100000000001
1000000000001
1000010000001
1000001010001
1000010000101
10000100N0001
1111111111111






