NO ./textures/11.xpm
SO ./textures/22.xpm
WE ./textures/33.xpm
EA ./textures/44.xpm

F 220,100,0
C 225,30,0

11111111  111111
1000000111100000111111
1011000000101101
10000001111000001
10110000000011101
1001000100000001
10111000100011101
10000N01111110001
10000111    10001
11111111    11111