NO ./textures/11.xpm
SO ./textures/22.xpm
WE ./textures/33.xpm
EA ./textures/44.xpm

F 138, 138, 123
C 125, 234, 245

11111111111111
11111111  111111
1000000111100000111111
1011000000101101
10000001111000001
10110000000011101
1001000100000001
1000000100011101
1000100100011101
1000001111100011
1001N011   110001
11111111    11111
11111111  111111

